//MAP CONVERTED BY dmm2tgm.py THIS HEADER COMMENT PREVENTS RECONVERSION, DO NOT REMOVE
"a" = (
/turf/open/floor/holofloor,
/area/template_noop)
"d" = (
/obj/structure/window/reinforced/spawner/directional/north,
/turf/open/floor/holofloor/grass,
/area/template_noop)
"h" = (
/obj/structure/window/reinforced/spawner/directional/east,
/turf/open/floor/holofloor/grass,
/area/template_noop)
"n" = (
/obj/structure/window/reinforced/spawner/directional/west,
/turf/open/floor/holofloor/grass,
/area/template_noop)
"o" = (
/obj/structure/window/reinforced/spawner/directional/south,
/turf/open/floor/holofloor/grass,
/area/template_noop)
"u" = (
/obj/structure/window/reinforced/spawner/directional/north,
/obj/structure/window/reinforced/spawner/directional/west,
/turf/open/floor/holofloor/grass,
/area/template_noop)
"v" = (
/obj/effect/holodeck_effect/ape_exhibit_controller,
/turf/open/floor/holofloor,
/area/template_noop)
"y" = (
/obj/structure/window/reinforced/spawner/directional/south,
/obj/structure/window/reinforced/spawner/directional/west,
/turf/open/floor/holofloor/grass,
/area/template_noop)
"F" = (
/obj/structure/window/reinforced/spawner/directional/east,
/obj/structure/window/reinforced/spawner/directional/north,
/turf/open/floor/holofloor/grass,
/area/template_noop)
"N" = (
/obj/structure/window/reinforced/spawner/directional/east,
/obj/structure/window/reinforced/spawner/directional/south,
/turf/open/floor/holofloor/grass,
/area/template_noop)
"Q" = (
/turf/open/floor/holofloor/grass,
/area/template_noop)

(1,1,1) = {"
v
a
a
a
a
a
a
a
a
a
"}
(2,1,1) = {"
a
a
u
y
a
a
u
y
a
a
"}
(3,1,1) = {"
a
u
Q
Q
n
n
Q
Q
y
a
"}
(4,1,1) = {"
a
d
Q
Q
Q
Q
Q
Q
o
a
"}
(5,1,1) = {"
a
d
Q
Q
Q
Q
Q
Q
o
a
"}
(6,1,1) = {"
a
d
Q
Q
Q
Q
Q
Q
o
a
"}
(7,1,1) = {"
a
F
Q
Q
h
h
Q
Q
N
a
"}
(8,1,1) = {"
a
a
F
N
a
a
F
N
a
a
"}
(9,1,1) = {"
a
a
a
a
a
a
a
a
a
a
"}
